aachen|Aachen, Germany
aarhus|Aarhus, Denmark
alicante|Alicante, Spain
amsterdam|Amsterdam, Netherlands
ancona|Ancona, Italy
andorra+la+vella|Andorra la Vella, Andorra
ankara|Ankara, Turkey
antalya|Antalya, Turkey
antwerp|Antwerp, Belgium
arezzo|Arezzo, Italy
athens|Athens, Greece
augsburg|Augsburg, Germany
barcelona|Barcelona, Spain
bari|Bari, Italy
barry|Barry, Wales
basel|Basel, Switzerland
bath|Bath, England
belfast|Belfast, Northern Ireland
belgrade|Belgrade, Serbia
bender|Bender, Moldova
bergen|Bergen, Norway
berlin|Berlin, Germany
bern|Bern, Switzerland
bilbao|Bilbao, Spain
blackpool|Blackpool, England
bologna|Bognor Regis, England
bonn|Bonn, Germany
bordeaux|Bordeaux, France
bratislava|Bratislava, Slovakia
brentwood|Brentwood, England
brighton|Brighton, England
bristol|Bristol, England
brno|Brno, Czech Republic
bruges|Bruges, Belgium
brussels|Brussels, Belgium
bucharest|Bucharest, Romania
budapest|Budapest, Hungary
burgas|Burgas, Bulgaria
burgos|Burgos, Spain
bursa|Bursa, Turkey
bury|Bury, England
cagliari|Caligari, Italy
calais|Calais, France
cambridge|Cambridge, England
cannes|Cannes, France
cardiff|Cardiff, Wales
ceske+budejovice|Carlisle, England
coimbra|Coimbra, Portugal
colmar|Colmar, France
cologne|Cologne, Germany
copenhagen|Copenhagen, Denmark
cordoba|Cordoba, Spain
cork|Cork, Ireland
coventry|Coventry, England
crawley|Crawley, England
derby|Derby, England
dortmund|Dortmund, Germany
dresden|Dresden, Germany
dublin|Dublin, Ireland
dubrovnik|Dubrovnik, Croatia
dundee|Dundee, Scotland
dusseldorf|Dusseldorf, Germany
edinburgh|Edinburgh, Scotland
erfurt|Erfurt, Germany
exeter|Exeter, England
falkirk|Falkirk, Scotland
fier|Fier, Albania
florence|Florence, Italy
galway|Galway, Ireland
geneva|Geneva, Switzerland
genoa|Genoa, Italy
glasgow|Glasgow, Scotland
gloucester|Gloucester, England
granada|Granada, Spain
graz|Graz, Austria
hamburg|Hamburg, Germany
hamilton|Hamilton, Scotland
helsinki|Helsinki, Finland
heraklion|Heraklion, Greece
hradec+kralove|Hradec Kralove, Czech Republic
innsbruck|Innsbruck, Austria
istanbul|Istanbul, Turkey
izmir|Izmir, Turkey
jerez+de+la+frontera|Jerez de la Frontera, Spain
katowice|Katowice, Poland
kazan|Kazan, Russia
konya|Konya, Turkey
krakow|Krakow, Poland
lausanne|Lausanne, Switzerland
le+havre|Le Havre, France
le+mans|Le Mans, France
leicester|Leicester, England
leipzig|Leipzig, Germany
lille|Lille, France
lincoln|Lincoln, England
linz|Linz, Austria
lisbon|Lisbon, Portugal
liverpool|Liverpool, England
livorno|Livorno, Italy
ljubljana|Ljubljana, Slovenia
london|London, England
lorca|Lorca, Spain
lucca|Lucca, Italy
ludwigsburg|Ludwigsburg, Germany
luxembourg|Ludwigshafen, Germany
luzern|Luzern, Switzerland
lyon|Lyon, France
maastricht|Maastricht, Netherlands
madrid|Madrid, Spain
mainz|Mainz, Germany
malaga|Malaga, Spain
malmo|Malmo, Sweden
manchester|Manchester, England
maribor|Maribor, Slovenia
marseille|Marseille, France
milan|Milan, Italy
monaco|Monaco
moscow|Moscow, Russia
mostar|Mostar, Bosnia and Herzegovina
munich|Munich, Germany
murcia|Murcia, Spain
nancy|Nancy, France
naples|Naples, Italy
nice|Nice, France
norwich|Norwich, England
odense|Odense, Denmark
olomouc|Olomouc, Czech Republic
oslo|Oslo, Norway
ostrava|Ostrava, Czech Republic
oxford|Oxford, England
padua|Padua, Italy
palermo|Palermo, Italy
pamplona|Pamplona, Spain
paris|Paris, France
patras|Patras, Greece
pecs|Pecs, Hungary
perugia|Perugia, Italy
piraeus|Piraeus, Greece
pisa|Pisa, Italy
plovdiv|Plovdiv, Bulgaria
poitiers|Poitiers, France
porto|Porto, Portugal
portsmouth|Portsmouth, England
prague|Prague, Czech Republic
prato|Prato, Italy
pula|Pula, Croatia
ravenna|Ravenna, Italy
reading|Reading, England
reims|Reims, France
reykjavik|Reykjavik, Iceland
riga|Riga, Latvia
rijeka|Rijeka, Croatia
rome|Rome, Italy
rotterdam|Rotterdam, Netherlands
rugby|Rugby, England
ruse|Ruse, Bulgaria
salamanca|Salamanca, Spain
sale|Sale, England
Salzburg|Salzburg, Austria
San+Marino|San Marino
Sarajevo|Sarajevo, Bosnia and Herzegovina
scarborough|Scarborough, England
segovia|Segovia, Spain
seville|Seville, Spain
siena|Siena, Italy
skopje|Skopje, Macedonia
slough|Slough, England
sofia|Sofia, Bulgaria
southampton|Southampton, England
split|Split, Croatia
stavanger|Stavanger, Norway
stockholm|Stockholm, Sweden
strasbourg|Strasbourg, France
stuttgart|Stuttgart, Germany
tallinn|Tallinn, Estonia
telford|Telford, England
the+hague|Tetovo, Macedonia
thessaloniki|Thessaloniki, Greece
toulouse|Toulouse, France
trondheim|Trondheim, Norway
turin|Turin, Italy
turku|Turku, Finland
utrecht|Utrecht, Netherlands
vaduz|Vaduz, Liechtenstein
valencia|Valencia, Spain
varna|Varna, Bulgaria
vatican+city|Vatican City
venice|Venice, Italy
verona|Verona, Italy
viareggio|Viareggio, Italy
vicenza|Vicenza, Italy
vienna|Vienna, Austria
warsaw|Warsaw, Poland
weimar|Weimar, Germany
woking|Woking, England
worthing|Worthing, England
wroclaw|Wroclaw, Poland
york|York, England
zagreb|Zagreb, Croatia
zamora|Zamora, Spain
zurich|Zurich, Switzerland
